*******                ******     ********
*******     ******     *********     **********
**

******
******
******

